.....╔══════╗...........
════╗║......║......█....
.╔══╬╝..╔═══╣...╗..║....
.║..║...║...╚═╦═╝╚╦╝....
.╚╦═╩═══╣.....║...║.....
..╚══...║.....╚═█═╝.....