.....╔══════╗...........
════╗║......║......█....
.╔══╬╝..╔═══╣..█╗..║....
.║..║...║...╚═╦═╝╚╦╝....
.╚╦═╩═══╣.....║...║.....
..╚══...║.....╚═══╝.....