.....╔══════╗...........
════╗║......║......█....
.╔═╔╬╝..╔═══╣..█╗..║....
.║..╚...║...╚═╦═╝╚╦╝....
.╚╦═╩═══╣.....║...║.....
..╚══...║.....╚═══╝.....